0000000000000000
0062700004000000
0312211111300000
0338833333300000
0008800000000000
0000000000000000
0000000000000000
0000000000000000
0000000000000000
0000000000000000
0000000000000000
1111111111111111
120
16
If you mess up, try again! Press F9 to restart the level.
