0000000000000000
0000000000000000
0000000000000000
0006000000000000
0003000000000000
0003000000000000
0003333111000000
0000003000000000
0000003000000000
0000003000000000
0000003001307000
1111111111111111
24
160
You can't jump. Use ladders instead. Use the arrow keys to climb ladders.