0000000000000000
0000000000000000
0000000000000000
0000000000000000
0000000000000000
0000000000000000
0000000000000000
0000000006000000
0000333333333333
0000402205550003
0000007100000003
0000001111888888
128
160
Level 8-1: End of port version 1.0.0 This is the end of the PC port Version 1.0.0