1111111111111111
1555555555555551
1111111111111151
1555555555555551
1511111111111111
1555555555555551
1111111111111151
1555555555555551
1511111111111111
1555555555555671
1111111111111111
1111111111111111
16
16
Collect coins. You need these to unlock areas.