0000000000000000
0000000000000000
0000000000000000
0000000000000000
0000000000000000
0000000000000000
0000000000000000
0000000000000000
0000000000000000
0000000000000000
6000000000000007
1111111111111111
120
160
Use the arrow keys to move. You need a key to open a door.