0000111133333311
0000130000041361
0111131881221331
0122031701001331
0133111351001331
0133100351001331
0133100351001331
0133100351001331
0133100351001331
0133100351001331
0133400351000331
0111111111088888
121
32
Level 7-1: Ladder something