0000000000000000
0000007000000000
0000311100000000
0000311100000000
0000300100000000
0000316100000000
0000314100000000
0000312100000000
0000300000000000
2220300000000000
2420300000000000
1111111111111111
16
160
Press Space to drop a bomb. Use bombs to blow up walls.