0000000000000000
0000000000000000
0000000000000000
0000000000000000
0038888800000000
0030000038880000
0030000030400000
8888881028800000
0000012021001000
6000012221888000
8888308880000000
0007888888888800
96
96
You are on your own now. Level 6-1: Invisible Maze